#################
#               #
# # # # # # # # #
# #   #  B#   # #
# # # # # # # # #
#   #   #   # # #
# ### # # ### # #
#A              #
#################