  # #   #B#
# # ### # #
# #     # #
# ## # ## #
#    #    #
#### ######
#         #
#A##### ###