#              B#
# ############# #
# #   #   #   # #
# # # # # # # # #
# # # # # # # # #
# # # # # # # # #
# # # # # # # # #
# # # # # # # # #
#   # # # # # # #
### #   #   #   #
A   #############