                        
##   # #### #####     # 
 #   #    #    B#    ## 
 #   #    #    #    # # 
 #   #    #   #    #  # 
 #   #    #  #    ######
###  #### # #####     # 
A                       